GGGGGGGGGG
GGGGSSSGGG
GGGSSSSGGG
GGSSWWSSGG
GSSWWWWSSG
GSSWWWWSSG
GGSSWWSSGG
GGGSSSSGGG
GGGGSSSGGG
GGGGGGGGGG
